----------------------------------------
-------x--------x------x--------x-------
-x----x-x------x-x----x-x------x-x----x-
--x--x---x----x---x--x---x----x---x--x--
---xx-----x--x-----xx-----x--x-----xx---
---xx------xx------xx------xx------xx---
--x--x-----xx-----x--x-----xx-----x--x--
-x----x---x--x---x----x---x--x---x----x-
-------x-x----x-x------x-x----x-x-------
--------x------x--------x------x--------
----------------------------------------
----------------------------------------
----------------------------------------
----------------------------------------
----------------------------------------
----------------------------------------
----------------------------------------
----------------------------------------
----------------------------------------
----------------------------------------
----------------------------------------
----------------------------------------
----------------------------------------
----------------------------------------
----------------------------------------
----------------------------------------
----------------------------------------
----------------------------------------
----------------------------------------
----------------------------------------