---------------------------------------
------xxxx-------------------xxxx------
----xx----xx---------------xx----xx----
---x--------x-----xxx-----x--------x---
--x----------x--xx---xx--x----------x--
--x----------x-x-------x-x----------x--
-x------------x---------x------------x-
-x-----xx-----x---------x-----xx-----x-
-x-----xx-----x---------x-----xx-----x-
-x------------x---------x------------x-
--x----------x-----------x----------x--
--x----------x-----------x----------x--
---x--------x-------------x--------x---
----xx----xx---------------xx----xx----
------xxxx-------------------xxxx------
---------------------------------------
---------------------------------------
---------------------------------------
---------------------------------------
---------------------------------------
---------------------------------------
---------------------------------------
---------------------------------------
---------------------------------------
---------------------------------------
---------------------------------------
---------------------------------------
---------------------------------------
---------------------------------------
---------------------------------------