---------------------------------------
----x--x--x--x--x--x--x--x--x--x--x----
---x--x--x--x--x--x-x--x--x--x--x--x---
----x--x--x--x--x--x--x--x--x--x--x----
-----s--------------------------s------
---------------------------------------
---------------------------------------
-----s--------------------------s------
----x--x--x--x--x--x--x--x--x--x--x----
---x--x--x--x--x--x-x--x--x--x--x--x---
----x--x--x--x--x--x--x--x--x--x--x----
---------------------------------------
---------------------------------------
---------------------------------------
---------------------------------------
---------------------------------------
---------------------------------------
---------------------------------------
---------------------------------------
---------------------------------------
---------------------------------------
---------------------------------------
---------------------------------------
---------------------------------------
---------------------------------------
---------------------------------------
---------------------------------------
---------------------------------------
---------------------------------------
---------------------------------------
