---------------------------------------
----------------xxxxxx-----------------
--------------xx------xx---------------
------------xx----------x--------------
-----------x-------------x-------------
----------x---------xx----x------------
---------x---------xxxx---x------------
---------x---------xxxx---x------------
--------x-----------xx---x-------------
--------x---------------x--------------
-------x---------------x-------xxx-----
-------x--------------x-------x---x----
-------x-------------x--------x---x----
-------x------------x---------x---x----
-------x------------x---------x---x----
-------x-------------x---------xxx-----
-------x--------------x----------------
-------x---------------x---------------
--------x---------------x--------------
--------x----------------x-------------
---------x---------------x-------------
---------x---------------x-------------
----------x-------------x--------------
-----------x-----------x---------------
------------xx-------xx----------------
--------------xxxxxxx------------------
---------------------------------------
---------------------------------------
---------------------------------------
---------------------------------------