---------------------------------------
---------------------------------------
-x-x-x-x-x-x-x-x-x-x-x-x-x-x-x-x-x-x-x-
---------------------------------------
-x-----------------x-----------------x-
---------------------------------------
-x-----------------x-----------------x-
------------------/-\------------------
-x----s-----a------b------c-----s----x-
------------------\-/------------------
-x-----------------x-----------------x-
---------------------------------------
-x-----------------x-----------------x-
---------------------------------------
-x-x-x-x-x-x-x-x-x-x-x-x-x-x-x-x-x-x-x-
---------------------------------------
---------------------------------------
---------------------------------------
---------------------------------------
---------------------------------------
---------------------------------------
---------------------------------------
---------------------------------------
---------------------------------------
---------------------------------------
---------------------------------------
---------------------------------------
---------------------------------------
---------------------------------------
---------------------------------------
