---------------------------------------
-------x--------x-----x--------x-------
-x----x-x------x-x---x-x------x-x----x-
--x--x---x----x---x-x---x----x---x--x--
---xx-----x--x-----x-----x--x-----xx---
---xx------xx------x------xx------xx---
--x--x-----xx-----x-x-----xx-----x--x--
-x----x---x--x---x---x---x--x---x----x-
-------x-x----x-x-----x-x----x-x-------
--------x------x-------x------x--------
---------------------------------------
---------------------------------------
---------------------------------------
---------------------------------------
---------------------------------------
---------------------------------------
---------------------------------------
---------------------------------------
---------------------------------------
---------------------------------------
---------------------------------------
---------------------------------------
---------------------------------------
---------------------------------------
---------------------------------------
---------------------------------------
---------------------------------------
---------------------------------------
---------------------------------------
---------------------------------------