
----------------------------------------
----------------------------------------
-xxxxxxxxxxxxxxxxxxxxxxxxxxxxxxxxxxxxxx-
----------------------------------------
-x-x-x-x-x-x-x-x-x-x-x-x-x-x-x-x-x-x-x--
--x-x-x-x-x-x-x-x-x-x-x-x-x-x-x-x-x-x-x-
----------------------------------------
-xxxxxxxxxxxxxxxxxxxxxxxxxxxxxxxxxxxxxx-
----------------------------------------
-x-x-x-x-x-x-x-x-x-x-x-x-x-x-x-x-x-x-x--
--x-x-x-x-x-x-x-x-x-x-x-x-x-x-x-x-x-x-x-
----------------------------------------
-xxxxxxxxxxxxxxxxxxxxxxxxxxxxxxxxxxxxxx-
----------------------------------------
--x-x-x-x-x-x-x-x-x-x-x-x-x-x-x-x-x-x-x-
-x-x-x-x-x-x-x-x-x-x-x-x-x-x-x-x-x-x-x--
----------------------------------------
-xxxxxxxxxxxxxxxxxxxxxxxxxxxxxxxxxxxxxx-
----------------------------------------
----------------------------------------
----------------------------------------
----------------------------------------
----------------------------------------
----------------------------------------
----------------------------------------
----------------------------------------
----------------------------------------
----------------------------------------
----------------------------------------
----------------------------------------