---------------------------------------
---------------------------------------
---------------------------------------
-----xx---xxx---xxx--xxx---xxx--xxx----
----x--x--x--x-x-----x--x--x----x------
----x--x--x--x-x-----x---x-x----x------
----x--x--xxx--x-----x---x-xxx--xxx----
----xxxx--x--x-x-----x---x-x----x------
----x--x--x--x-x-----x--x--x----x------
----x--x--xxx---xxx--xxx---xxx--x------
---------------------------------------
---------------------------------------
---------------------------------------
---------------------------------------
---------------------------------------
---------------------------------------
---------------------------------------
---------------------------------------
---------------------------------------
---------------------------------------
---------------------------------------
---------------------------------------
---------------------------------------
---------------------------------------
---------------------------------------
---------------------------------------
---------------------------------------
---------------------------------------
---------------------------------------
---------------------------------------