---------------------------------------
-/\/\/\/\/\/\/\/\/\/\/\/\/\/\/\/\/\/\/-
---------------------------------------
---x--x--x--x--x--x--x--x--x--x--x--x--
---------------------------------------
-xxxxxxxxxxxxxxxxxxxxxxxxxxxxxxxxxxxxx-
---------------------------------------
---x--x--x--x--x--x--x--x--x--x--x--x--
---------------------------------------
---------------------------------------
---------------------------------------
---------------------------------------
---------------------------------------
---------------------------------------
---------------------------------------
---------------------------------------
---------------------------------------
---------------------------------------
---------------------------------------
---------------------------------------
---------------------------------------
---------------------------------------
---------------------------------------
---------------------------------------
---------------------------------------
---------------------------------------
---------------------------------------
---------------------------------------
---------------------------------------
---------------------------------------