---------------------------------------
---------------------------------------
------xxxx------------------xxxx-------
-----x----x-----xxxxxx-----x----x------
----x------x--xx------xx--x------x-----
----x------xxx----------xxx------x-----
----x------x--------------x------x-----
----x-----x-xxx--------xxx-x-----x-----
----x----x-x---x------x---x-x----x-----
-----x---xx----x------x----xxx--x------
------xxx-x----x------x----x-xxx-------
--------x-x---x--------x---x-x---------
-------x---xxx----------xxx---x--------
-------x----------------------x--------
-------x-xxxxx----------xxxxx-x--------
-------x-x----xxxxxxxxxx----x-x--------
-------x-x------------------x-x--------
-------x--x----------------x--x--------
-------x--x----------------x--x--------
--------x--x--------------x--x---------
--------x--x--------------x--x---------
---------x--x------------x--x----------
---------x---x----------x---x----------
----------x---x--------x---x-----------
-----------x---x------x---x------------
------------xx--xxxxxx--xx-------------
--------------xx------xx---------------
----------------xxxxxx-----------------
---------------------------------------
---------------------------------------