
----------------------------------------
----------------------------------------
----------------------------------------
--------xxxxxx----------xxxxxx----------
-------x----------------------x---------
------x------------------------x--------
-----x---xxxx------------xxxx---x-------
--------x----x----------x----x----------
--------x----x----------x----x----------
-------x--xx--x--------x--xx--x---------
-------x-xx-x-x--------x-xx-x-x---------
-------x-xxxx-x--------x-xxxx-x---------
-------x-xxxx-x--------x-xxxx-x---------
-------x-xxxx-x--------x-xxxx-x---------
-------x--xx--x--------x--xx--x---------
--------x----x----------x----x----------
---------xxxx------------xxxx-----------
----------------------------------------
----------------------------------------
------------x------------x--------------
-----------x--------------x-------------
-----------x------xx------x-------------
-----------x-----x--x-----x-------------
------------x---x----x---x--------------
-------------xxx------xxx---------------
----------------------------------------
----------------------------------------
----------------------------------------
----------------------------------------
----------------------------------------