
----------------------------------------
-----------------------x----------------
------xxx-------------xxx---------------
--xx-x---x-xx--------xx-xx---------xx---
-x--x-----x--x------xx---xx-------x--x--
-x-----------x-----xx-----xx------x--x--
--x---------x-----xxx-x----xx------xx---
---xxxxxxxxx-----xx-xx-x-x-xxx----------
----------------xx-x-x-xxxxx-xx---------
---------------xx-x-x-x-x-x-x-xx--------
--------------xx-x-x-x-x-x-x-x-xx-------
-------------xx-x-x-x-x-x-x-x-x-xx------
------------xx-x-x-x-x-x-x-x-x-x-xx-----
-----------xx-x-x-x-x-x-x-x-x-x-x-xx----
-xxxxxxxxxxx-x-x-x-x-x-x-x-x-x-x-x-xxxx-
--x-x-x-x-x-x-x-x-x-x-x-x-x-x-x-x-x-x-x-
-x-x-x-x-x-x-x-x-x-x-x-x-x-x-x-x-x-x-x--
-xxxxxxxxxxxxxxxxxxxxxxxxxxxxxxxxxxxxxx-
----------------------------------------
----------------------------------------
----------------------------------------
----------------------------------------
----------------------------------------
----------------------------------------
----------------------------------------
----------------------------------------
----------------------------------------
----------------------------------------
----------------------------------------
----------------------------------------