---------------------------------------
-----------------xxxxx-----------------
---------------xxxxxxxxx---------------
--------------xxxxxxxxxxx--------------
-------------/----xxx----\-------------
------------/-----xxx-----\------------
-----------/------xxx------\-----------
-----------xxxxxxxxxxxxxxxxx-----------
----------/-------xxx-------\----------
---------/--------xxx--------\---------
--------/---------xxx---------\--------
--------xxxxxxxxxxxxxxxxxxxxxxx--------
-------/----------xxx----------\-------
------/-----------xxx-----------\------
-----/------------xxx------------\-----
-----xxxxxxxxxxxxxxxxxxxxxxxxxxxxx-----
----/-------------xxx-------------\----
---/--------------xxx--------------\---
--/---------------xxx---------------\--
------------------xxx------------------
--xxxxxxxxxxxxxxxxxxxxxxxxxxxxxxxxxxx--
------------------xxx------------------
----------------xxxxxxx----------------
-----------------xxxxx-----------------
-----------------xxxxx-----------------
---------------------------------------
---------------------------------------
---------------------------------------
---------------------------------------
---------------------------------------