---------------------------------------
-xxxxxx--------------------------------
-------x-----------xx---------xxxxx----
-----x--x---\-/---xxxx-------x-----x---
----x-x--x---x----xxxx-\-/--x--x-x--x--
----x-x---x--------xx---x--x------x--x-
----xxx---xx---------------x-xx-xx-x-x-
----------x----------------x-x-x--x-xx-
-xxxxxxxxxx----------------x-x--x----x-
----------x----------------x-------x-x-
-xxxxxxxx-x-----------------x-x-xx--x--
-x--xx--x-x------------------x----xx---
-x--xx--x-x-------------------xxxxx----
-xxxxxxxx-x---------------------x------
----------x--x----x-----x-------x------
-xxxx-xxx-xxxxxxxxxxxxxxx-------x------
-x--x-xxx-x--x----x-----x-------x------
-x--x-xxx-x--x----x-----x-------x------
-xxxx-xxx-xxxxxxxxxxxxxxx-------x------
------xxx-x--x----x-----x------x-x-----
-xxxxxxxxxxxxxxxxxxxxxxxxxxxxxxxxxxxxx-
---------------------------------------
---------------------------------------
---------------------------------------
---------------------------------------
---------------------------------------
---------------------------------------
---------------------------------------
---------------------------------------
---------------------------------------